5 5
WWWWW
WSa0W
WWAWW
WWGWW
WWWWW