11 7
WWWWWWWWWWW
WS0000000aW
WWWWWAWWWWW
W00000000bW
WWWWWBWWWWW
W000000000W
W00000000GW
WWWWWWWWWWW