15 11
WWWWWWWWWWWWWWW
WS000000000000W
WWWWWWWaWWWWWWW
W0W000000000W0W
WWWAWWWWWWWWWWW
W0000000000000W
W000000W00000bW
WWWWWWWWBWWWWWW
W000000000000cW
WWWWWWWCWWWWWWW
W000000000000GW
WWWWWWWWWWWWWWW